5 9 3 3 3 2 2 2 2 2 
9 9 3 3 3 1 2 8 2 2 
9 9 9 8 3 3 1 1 . 8 
5 5 8 8 8 8 1 1 1 6 
5 5 . 8 8 1 1 8 6 6 
5 5 . . . 1 1 . 6 6 
5 5 9 9 1 1 4 . 6 6 
8 3 9 9 4 4 4 4 0 0 
7 7 7 7 4 4 4 . 0 0 
7 7 7 7 4 4 4 0 0 0 
