0 0 0 . 9 1 9 . 3 3 3 . 2 2 2 
0 0 . . . 9 . 3 . . 3 . . . 2 
0 0 . . . . . 3 3 3 . . 2 2 2 
0 0 . . 9 . 9 1 3 3 3 . . 2 2 
. . . 8 8 8 5 . 9 3 3 3 2 . 2 
6 . 0 . 8 . 5 . 5 . 3 . . . 2 
6 6 6 8 1 . 5 5 5 5 . . . 8 8 
6 6 . . 8 . . 5 5 5 . . 8 8 8 
6 . . . . . . . 5 5 . . 8 . 8 
6 . . 1 8 . 1 5 5 5 . 8 8 8 . 
6 6 . . . 1 8 . . . . . 8 3 . 
4 . . 8 . 1 . 9 9 . . . . 7 7 
. . . . 8 . 9 9 . 4 9 . . . 7 
4 4 4 . . 1 1 4 4 4 . . 7 7 7 
4 4 4 . 1 1 1 9 9 7 7 7 7 7 7 
